+++++++++++++++++++++++
+++-+-+-+-+-+-+-+-+-+++
++S         |       |++
+++ +-+-+-+ +-+-+ + +++
++| |       |   | | |++
+++-+ +-+-+-+ + + + +++
++|   |   |   | | | |++
+++ +-+ + + +-+ +-+ +++
++| |   |   |   |   |++
+++ + +-+ +-+ +-+ +-+++
++|     | |   |     |++
+++-+-+-+ + +-+ + +-+++
++| |   | |     |   |++
+++ + + + +-+-+-+-+ +++
++|   |   | |   |   |++
+++ +-+-+-+ + +-+ + +++
++| +-+-+-+-+ +-+ + +++
++|         | |   | |++
+++-+-+ +-+-+ + +-+ +++
++|     |       |   E++
+++-+-+-+-+-+-+-+-+-+++
+++++++++++++++++++++++