+-+-+-+-+-+-+-+-+-+-+-+-+-+
S   |     |   |     |     |
+-+ + + +-+ + + +-+ +-+-+ +
|   | | |   |   |   |   | |
+ +-+ + + +-+-+-+ +-+ + + +
|     | |     |     | |   |
+ +-+-+-+-+-+ + +-+ + + +-+
| |     |   | |   |   | | |
+ + + + + +-+ +-+ +-+-+ + +
| | | |   |   | |   |   | |
+ + + +-+-+ +-+ +-+ + +-+ +
|   |   |   |   |   |     |
+-+-+ + + +-+-+ + +-+-+-+-+
|     | |   |     |   |   |
+ +-+-+-+ + + +-+-+-+ + + +
|     |   | |     |   | | |
+-+-+ + +-+-+-+ +-+ +-+ + +
|   | | |   |   |   |   | |
+-+ + + + + + +-+ +-+ +-+ +
|   |     | |     |   |   |
+ +-+ + +-+ +-+-+-+ +-+ +-+
|     | | |       | | |   |
+-+-+-+ + +-+ +-+-+ + +-+ +
|   |   | | |   |   |     |
+ +-+ + + + +-+ + + +-+-+-+
|     |   |       |       E
+-+-+-+-+-+-+-+-+-+-+-+-+-+