+-+-+-+-+-+-+-+-+-+-+-+-+-+-+-+
S       |       |       | |   |
+-+-+-+ + +-+-+ +-+ +-+ + + + +
| |     |   |   |   |   | | | |
+ + + +-+-+ + +-+ +-+ +-+ + +-+
|   | |     | | |   |     |   |
+-+-+ + +-+-+ + + + +-+-+ + + +
|   | |   |   |   |     | | | |
+ + + +-+ + +-+-+-+-+-+ + +-+ +
| | | |   |           | |   | |
+-+ + + +-+-+-+-+-+-+ + +-+ + +
|   | |   | |       |   | | | |
+ +-+ +-+ + + +-+-+ + +-+ + + +
|   | | | | | |   |   |     | |
+-+ + + + + + +-+ +-+-+ + +-+ +
| |   |   | |   |   |   | | | |
+ + + + +-+ +-+ +-+ + +-+ + + +
| | | | |       |   |   |     |
+ +-+ + + + +-+ + +-+-+-+-+ +-+
|       | |   |   |       | | |
+ +-+-+-+ +-+-+-+ + +-+ +-+ + +
| |     |     | | |   | |   | |
+ + +-+-+-+-+ + + +-+-+ + +-+ +
| |     |   | | | | |   |     |
+ +-+-+ + +-+ + + + + + +-+-+-+
|     | |     |   |   |     | |
+ +-+ + +-+-+-+-+-+ +-+-+-+ + +
|   | |   |             |   | |
+-+ + +-+ + +-+-+-+ +-+ + +-+ +
|   |       |       |   |     E
+-+-+-+-+-+-+-+-+-+-+-+-+-+-+-+