+-+-+-+-+-+-+-+-+-+-+-+-+-+-+-+-+-+-+-+
S             |   |         |   |     |
+ +-+-+-+-+ + + + +-+ +-+-+ +-+ +-+-+ +
|     |     | | |     |     |     |   |
+-+-+ +-+-+-+ + +-+-+-+ + +-+ +-+ + +-+
|   |     |   | |   |   |     |       |
+-+ +-+-+ + +-+ + +-+ +-+-+-+-+ + +-+-+
|   |     |     |     | |       |     |
+ +-+ +-+-+-+-+-+-+-+-+ + +-+-+-+ +-+ +
| |     |   | |         |   | |     | |
+ + +-+-+ + + + + +-+-+-+-+ + + +-+-+ +
| | |     | |   |           |   |   | |
+ + + +-+-+ +-+-+-+-+-+ +-+-+-+-+ + + +
|   |     |       |   |     |     |   |
+-+-+-+-+ +-+-+-+ +-+ +-+-+ + +-+ +-+-+
|   |   |   |   |   |       | |   |   |
+ +-+ + +-+ + +-+-+ + +-+-+-+ + +-+-+ +
| |   |     |   |   |   |     | |   | |
+ + +-+-+-+-+-+ + +-+ + + +-+-+ +-+ + +
|   |   |   |   |     | | |   |     | |
+ +-+-+ + + + +-+-+-+-+ + + + +-+-+ + +
| |   | | | |         | |   | |     | |
+ + + + + +-+-+ +-+-+ + +-+-+ + +-+-+ +
|   | | |     |   | |   |     |       |
+ +-+ + +-+-+ + + + +-+-+ +-+-+-+-+-+-+
|   |         | |   |                 E
+-+-+-+-+-+-+-+-+-+-+-+-+-+-+-+-+-+-+-+